111111111111111
100000000000001
101001111001101
100011E00C1C001
110000101110001
111C01100001001
10P000000000001
1111111P1111111
