111111111111111
100000000000001
101001111001101
100011E00C1C001
110000101110001
111C01100001001
1P0000000000001
111111111111111
