1111111111111111
1111100000000001
10E1100000000001
1111100000000001
10000000000C0001
1000000000000001
1000000000000001
10000P0000000001
1000000000000001
1111111111111111