1111111111111111
1000000000000001
10E0000000000001
1000000000000001
10000000000C0001
1000000000000001
10000a0000000001
10000P0000000001
1000000000000001
1111111111111111
