11111111111111111111111111111
1111111111111111111111111PCE1
11111111111111111111111111111